50 20 20
levels/1_first_enemy.txt
LLLLLLLLLLL
LLLLLLLLLLL
LL   G   LL
LL L   L LL
LL LLLLL LL
LL L   L LL
LL       LL
LL LLLLL LL
LL   L   LL
LL LLLLL LL
LL   p   LL
LLLLLLLLLLL
LLLLLLLLLLL