50 40 40
levels/5_i_can_teleport.txt
LLLLLLLLLLLLL
LLLLLLLLLLLLL
LLLL  G  LLLL
LLL   w   LLL
LL  L   L  LL
LLL       LLL
LLLL  p  LLLL
LLLLLLLLLLLLL
LLLLLLLLLLLLL