50 40 40
levels/7_wyrm_spawner.txt
LLLLLLLLLLLLL
LLLLLLLLLLLLL
LLLLL G LLLLL
LLLLLD DLLLLL
LLLLL   LLLLL
LLLLL   LLLLL
LLLLLDwDLLLLL
LLLLL   LLLLL
LLLLL   LLLLL
LLLLLd dLLLLL
LLLLL   LLLLL
LLLLL p LLLLL
LLLLLLLLLLLLL