50 40 40
NONE
LLLLLLLLLLL
LLLLLLLLLLL
LLLLLGLLLLL
LLLLL LLLLL
LLL     LLL
LL  LWL  LL
LL       LL
LL  L L  LL
LL      LLL
LLLLL LLLLL
L   L L   L
L L L L L L
L   L L   L
LLL L LLL L
L L L L L L
L L L L L L
L   LpL   L
LLLLLLLLLLL
LLLLLLLLLLL