50 21 17
levels/test.txt
LLLLLLLLLLLLLLLLLLLLLL
LL   Y         D    GL
LL LLLLLLLLLLLLLLLL LL
LL L             L  LL
LL L LLLLLLLL LLL L LL
LL L Ld    dL L   L LL
LL   L  p   L LLL L LL
LL L Ld    dL     L LL
LL L LLL  LLL LLL L LL
LL L     Y     L  L LL
LL LLLLLLLLLL LLLLL LL
LL                  LL
LL LLLLLLLLLLLL   LLLL
LL   LLLLLLLL   D   LL
LL         LLLLLLLLLLL
LL   D            G LL
LLLLLLLLLLLLLLLLLLLLLL
