200 11 9
LLLLLLLLLLL
LLLLLLLLLLL
LL   p   LL
LL       LL
LL       LL
LL       LL
LL   Y   LL
LLLLLLLLLLL
LLLLLLLLLLL